**********
*P       *
*        *
*        *
*        *
*        *
*   * ****
*   *    *
*     * G*
**********

